11111
1P0E1
10C01
11111

11111
10001
10001
11111
