11111
10001
10E01
10001
10C01
10001
10P01
11111
