11111
10001
1EEE1
1EEE1
1EEE1
10C01
10001
10P01
11111
