1111111111111111111111111111111111
1E0000000000000C00000C000000000001
1010010100100000101001000110010101
10100100101010100010011C0000010101
100000000C00C0000000001110000000C1
101000P00011000001111010000C000001
1C10000000100000000C10000000000001
1111111111111111111111111111111111
