111111111
1C0E0C101
1C000C101
1C000C1C1
1C0P0C101
100000101
111111111
