1111111
100E001
1000001
1C000C1
100P001
1000001
1111111
